111111111111111111111
1000000000000000000P1
101000100010001101101
100000000000000000011
101000100010001101101
1010001000C0001101101
100000000000001101111
1000000000000011011E1
111111111111111111111