111111111111111111111111111111111111
1000C0000001110011100111110000000011
1000000000011C0011C0011C110000000011
10000PE000011C0011C0011C110000000011
1000000000011C0011C0011C110000000011
100000000000000000000000000000000001
111111111111111111111111111111111111