111111111111111111111
10P000000000000000001
101000100010001101101
10000M0000000M0000011
101000100010001101101
10100010E0C0001101101
100000000000001101111
100000000M00001101101
111111111111111111111