1111111111111111111111111
111100000C00000C0000000C1
10C0011111111111111111111
1000000000000000000000001
1000C00000011111000000001
1000000000011C11000000001
1P00000000000000000000001
1000C000E0000000000000001
1111111111111111111111111