1111111111
1E00011111
1010011111
1010011111
10100111C1
1010011111
1010011111
1111111101
1111111001
1111111111
1111111P11
1111111111