111111111111111
1P0000000000001
10C000001101101
10C000001101101
100000E01101101
100000001101101
111111111111111