111111111111111
1000000000000P1
10C000001101101
10C000001101101
100000E01101101
100000001101101
111111111111111