1111111111
1E00011111
101C011111
101C011111
101C011111
101C011111
101C011111
101C011111
101C011111
101C011111