1111111111
1111000001
10C0111111
1000000001
1000C00001
1000000001
1P00000001
1000C000E1
1111111111