1111111111
1111000001
1000111111
1000000001
1000000001
1000000001
1P00000001
10000000E1
1111111111