1111111
1E00011
101C011
1010001
1P00011
1111111