111111111111111
1PC000000000001
101111111111101
101000000000001
101011111111101
100010000000001
111011101111111
1000010E0000001
101111101111111
100000001000101
111111111111111