111111111111111111111111111111111111111111111111111111111111111111111111111111111111111111111111111111111111111111111111111111111111111
111100000C0000C0000C0000C0000C0000C0000C0000C0000C0000C0000C0000C0000C0000C0000C0000C0000C0000C0000C0000C0000C0000C0000C00000C0000000C1
10C001111111111111111111111111111111111111111111111111111111111111111111111111111111111111111111111111111111111111111111111111111111111
100000000000000000000000000000000000000000000000000000000000000000000000000000000000000000000000000000000000000000000000000000000000001
1000C0000001110011100111001110011100111001110011100111001110011100111001110011100111001110011100111001110011100111001110011111000000001
10C001111111111111111111111111111111111111111111111111111111111111111111111111111111111111111111111111111111111111111111111111111111111
100000000000000000000000000000000000000000000000000000000000000000000000000000000000000000000000000000000000000000000000000000000000001
1000C0000001110011100111001110011100111001110011100111001110011100111001110011100111001110011100111001110011100111001110011111000000001
10C001111111111111111111111111111111111111111111111111111111111111111111111111111111111111111111111111111111111111111111111111111111111
100000000000000000000000000000000000000000000000000000000000000000000000000000000000000000000000000000000000000000000000000000000000001
1000C0000001110011100111001110011100111001110011100111001110011100111001110011100111001110011100111001110011100111001110011111000000001
10C001111111111111111111111111111111111111111111111111111111111111111111111111111111111111111111111111111111111111111111111111111111111
100000000000000000000000000000000000000000000000000000000000000000000000000000000000000000000000000000000000000000000000000000000000001
1000C0000001110011100111001110011100111001110011100111001110011100111001110011100111001110011100111001110011100111001110011111000000001
10C001111111111111111111111111111111111111111111111111111111111111111111111111111111111111111111111111111111111111111111111111111111111
100000000000000000000000000000000000000000000000000000000000000000000000000000000000000000000000000000000000000000000000000000000000001
1000C0000001110011100111001110011100111001110011100111001110011100111001110011100111001110011100111001110011100111001110011111000000001
10C001111111111111111111111111111111111111111111111111111111111111111111111111111111111111111111111111111111111111111111111111111111111
100000000000000000000000000000000000000000000000000000000000000000000000000000000000000000000000000000000000000000000000000000000000001
1000C0000001110011100111001110011100111001110011100111001110011100111001110011100111001110011100111001110011100111001110011111000000001
10C001111111111111111111111111111111111111111111111111111111111111111111111111111111111111111111111111111111111111111111111111111111111
100000000000000000000000000000000000000000000000000000000000000000000000000000000000000000000000000000000000000000000000000000000000001
1000C0000001110011100111001110011100111001110011100111001110011100111001110011100111001110011100111001110011100111001110011111000000001
10C001111111111111111111111111111111111111111111111111111111111111111111111111111111111111111111111111111111111111111111111111111111111
100000000000000000000000000000000000000000000000000000000000000000000000000000000000000000000000000000000000000000000000000000000000001
1000C0000001110011100111001110011100111001110011100111001110011100111001110011100111001110011100111001110011100111001110011111000000001
10C001111111111111111111111111111111111111111111111111111111111111111111111111111111111111111111111111111111111111111111111111111111111
100000000000000000000000000000000000000000000000000000000000000000000000000000000000000000000000000000000000000000000000000000000000001
1000C0000001110011100111001110011100111001110011100111001110011100111001110011100111001110011100111001110011100111001110011111000000001
10C001111111111111111111111111111111111111111111111111111111111111111111111111111111111111111111111111111111111111111111111111111111111
100000000000000000000000000000000000000000000000000000000000000000000000000000000000000000000000000000000000000000000000000000000000001
1000C0000001110011100111001110011100111001110011100111001110011100111001110011100111001110011100111001110011100111001110011111000000001
10C001111111111111111111111111111111111111111111111111111111111111111111111111111111111111111111111111111111111111111111111111111111111
100000000000000000000000000000000000000000000000000000000000000000000000000000000000000000000000000000000000000000000000000000000000001
1000C0000001110011100111001110011100111001110011100111001110011100111001110011100111001110011100111001110011100111001110011111000000001
10C001111111111111111111111111111111111111111111111111111111111111111111111111111111111111111111111111111111111111111111111111111111111
100000000000000000000000000000000000000000000000000000000000000000000000000000000000000000000000000000000000000000000000000000000000001
1000C0000001110011100111001110011100111001110011100111001110011100111001110011100111001110011100111001110011100111001110011111000000001
10C001111111111111111111111111111111111111111111111111111111111111111111111111111111111111111111111111111111111111111111111111111111111
100000000000000000000000000000000000000000000000000000000000000000000000000000000000000000000000000000000000000000000000000000000000001
100000000000000000000000000000000000000000000000000000000000000000000000000000000000000000000000000000000000000000000000000000000000001
100000000000000000000000000000000000000000000000000000000000000000000000000000000000000000000000000000000000000000000000000000000000001
100000000000000000000000000000000000000000000000000000000000000000000000000000000000000000000000000000000000000000000000000000000000001
100000000000000000000000000000000000000000000000000000000000000000000000000000000000000000000000000000000000000000000000000000000000001
100000000000000000000000000000000000000000000000000000000000000000000000000000000000000000000000000000000000000000000000000000000000001
100000000000000000000000000000000000000000000000000000000000000000000000000000000000000000000000000000000000000000000000000000000000001
100000000000000000000000000000000000000000000000000000000000000000000000000000000000000000000000000000000000000000000000000000000000001
100000000000000000000000000000000000000000000000000000000000000000000000000000000000000000000000000000000000000000000000000000000000001
100000000000000000000000000000000000000000000000000000000000000000000000000000000000000000000000000000000000000000000000000000000000001
1000C0000001110011100111001110011100111001110011100111001110011100111001110011100111001110011100111001110011100111001110011111000000001
10C001111111111111111111111111111111111111111111111111111111111111111111111111111111111111111111111111111111111111111111111111111111111
100000000000000000000000000000000000000000000000000000000000000000000000000000000000000000000000000000000000000000000000000000000000001
1000C0000001110011100111001110011100111001110011100111001110011100111001110011100111001110011100111001110011100111001110011111000000001
10C001111111111111111111111111111111111111111111111111111111111111111111111111111111111111111111111111111111111111111111111111111111111
100000000000000000000000000000000000000000000000000000000000000000000000000000000000000000000000000000000000000000000000000000000000001
1000C0000001110011100111001110011100111001110011100111001110011100111001110011100111001110011100111001110011100111001110011111000000001
10C001111111111111111111111111111111111111111111111111111111111111111111111111111111111111111111111111111111111111111111111111111111111
100000000000000000000000000000000000000000000000000000000000000000000000000000000000000000000000000000000000000000000000000000000000001
1000C0000001110011100111001110011100111001110011100111001110011100111001110011100111001110011100111001110011100111001110011111000000001
10C001111111111111111111111111111111111111111111111111111111111111111111111111111111111111111111111111111111111111111111111111111111111
100000000000000000000000000000000000000000000000000000000000000000000000000000000000000000000000000000000000000000000000000000000000001
1000C0000001110011100111001110011100111001110011100111001110011100111001110011100111001110011100111001110011100111001110011111000000001
10C001111111111111111111111111111111111111111111111111111111111111111111111111111111111111111111111111111111111111111111111111111111111
100000000000000000000000000000000000000000000000000000000000000000000000000000000000000000000000000000000000000000000000000000000000001
1000C0000001110011100111001110011100111001110011100111001110011100111001110011100111001110011100111001110011100111001110011111000000001
10C001111111111111111111111111111111111111111111111111111111111111111111111111111111111111111111111111111111111111111111111111111111111
100000000000000000000000000000000000000000000000000000000000000000000000000000000000000000000000000000000000000000000000000000000000001
1000C0000001110011100111001110011100111001110011100111001110011100111001110011100111001110011100111001110011100111001110011111000000001
10C001111111111111111111111111111111111111111111111111111111111111111111111111111111111111111111111111111111111111111111111111111111111
100000000000000000000000000000000000000000000000000000000000000000000000000000000000000000000000000000000000000000000000000000000000001
100000000000000000000000000000000000000000000000000000000000000000000000000000000000000000000000000000000000000000000000000000000000001
100000000000000000000000000000000000000000000000000000000000000000000000000000000000000000000000000000000000000000000000000000000000001
100000000000000000000000000000000000000000000000000000000000000000000000000000000000000000000000000000000000000000000000000000000000001
100000000000000000000000000000000000000000000000000000000000000000000000000000000000000000000000000000000000000000000000000000000000001
100000000000000000000000000000000000000000000000000000000000000000000000000000000000000000000000000000000000000000000000000000000000001
1000C0000001110011100111001110011100111001110011100111001110011100111001110011100111001110011100111001110011100111001110011111000000001
1000000000011C0011C0011C0011C0011C0011C0011C0011C0011C0011C0011C0011C0011C0011C0011C0011C0011C0011C0011C0011C0011C0011C0011C11000000001
1000000000011C0011C0011C0011C0011C0011C0011C0011C0011C0011C0011C0011C0011C0011C0011C0011C0011C0011C0011C0011C0011C0011C0011C11000000001
1P0000000000000000000000000000000000000000000000000000000000000000000000000000000000000000000000000000000000000000000000000000000000001
1000C000E000000000000000000000000000000000000000000000000000000000000000000000000000000000000000000000000000000000000000000000000000001
111111111111111111111111111111111111111111111111111111111111111111111111111111111111111111111111111111111111111111111111111111111111111