111111111111111
1PCE00000000001
101111111111101
101000000000001
101011111111101
100010000000001
111011101111111
100001000000001
101111101111101
100000001000001
111111111111111