11111111111111111111111
1P000000000000000000001
10C000C000C000001101101
10000000000000000000011
10C000C000C000001101101
10C000C000C000001101101
10000000000000E01101101
10000000000000001101101
11111111111111111111111