111111111111111111111
100000000000000000001
101000100010001101101
100000000000000000011
101000100010001101101
10100010E0C0001101101
100000000000001101111
100000000000001101101
111111111111111111111