1111111111111111111111111111111111
100000000000000C00000C000000000001
1010010100100000101001000000010101
1010010100100000101001000000010111
100000000C00C00000000000000000P1E1
1111111111111111111111111111111111