111111111111111111111
1MP000000000000000001
101000100010001101101
10000M0000000M0000011
101000100010001101101
10MMM010E0M0001101101
10MC00000000001101111
10MMM0000M00001101101
111111111111111111111